
AAB = "countries/AitAbbas.txt" #BT
AAL = "countries/Aaland.txt" #BT
ABD = "countries/Abdallab.txt" #BT
ABR = "countries/Abruzzo.txt" #BT
ADR = "countries/Andria.txt" #BT
AJO = "countries/Alentejo.txt" #BT
ALI = "countries/Alaiye.txt" #BT
ALP = "countries/AlbaPiedmont.txt" #BT
ALQ = "countries/Algonquin.txt" #BT
ALR = "countries/Alatri.txt" #BT; changed from ALT
ALX = "countries/Alexandria.txt" #BT
ANC = "countries/Ancona.txt" #BT
ANF = "countries/Anfa.txt" #BT
ANI = "countries/AngloIreland.txt" #BT
ANJ = "countries/ProvenceBT.txt" #BT
ANR = "countries/Antrim.txt" #BT
AOR = "countries/Andorra.txt" #BT
APU = "countries/Apulia.txt" #BT
ARE = "countries/Arezzo.txt" #BT
ARR = "countries/Arborea.txt" #BT
ARU = "countries/Aru.txt" #BT
ASC = "countries/Auschwitz.txt" #BT
ASD = "countries/Alessandria.txt" #BT
ATC = "countries/Antioch.txt" #BT
ATI = "countries/Asti.txt" #BT
ATR = "countries/Atri.txt" #BT
ATS = "countries/Artois.txt" #BT
AUR = "countries/Aures.txt" #BT
AZD = "countries/Azd.txt" #BT
BAI = "countries/Bari.txt" #BT
BAU = "countries/Breslau.txt" #BT
BCH = "countries/Berchtesgaden.txt" #BT
BDI = "countries/Badinan.txt" #BT
BDN = "countries/Vidin.txt" #BT
BEG = "countries/Brieg.txt" #BT
BEL = "countries/Belgium.txt" #BT
BET = "countries/Beuthen.txt" #BT
BGM = "countries/Bergamo.txt" #BT
BIB = "countries/Biberach.txt" #BT
BIF = "countries/Breifne.txt" #BT
BIN = "countries/Bingol.txt" #BT 
BKJ = "countries/Baekje.txt" #BT
BLL = "countries/Belluno.txt" #BT
BLV = "countries/Belyov.txt" #BT
BMA = "countries/Bima.txt" #BT
BOB = "countries/Bobbio.txt" #BT
BRC = "countries/Brecon.txt" #BT
BRD = "countries/Bardi.txt" #BT
BRM = "countries/Burma.txt" #BT
BRX = "countries/Brixen.txt" #BT
BSA = "countries/Besancon.txt" #BT
BSC = "countries/Brescia.txt" #BT
BSL = "countries/Basel.txt" #BT
BSM = "countries/BanuSulaym.txt" #BT
BTH = "countries/Bentheim.txt" #BT
BUC = "countries/Buchau.txt" #BT
BVR = "countries/Beaver.txt" #BT
CAG = "countries/Cagliari.txt" #BT
CAP = "countries/Cappadocia.txt" #BT
CBG = "countries/CalenbergBT.txt" #BT
CBR = "countries/Calabria.txt" #BT
CCC = "countries/Cochinchina.txt" #BT
CDA = "countries/Candia.txt" #BT
CDB = "countries/Cordoba.txt" #BT
CDC = "countries/CittadiCastello.txt" #BT
CEL = "countries/TirNaCeltigh.txt" #BT
CEN = "countries/Ceneda.txt" #BT
CEV = "countries/Ceva.txt" #BT
CHS = "countries/Chumash.txt" #BT
CIE = "countries/Chieri.txt" #BT
CIK = "countries/Canik.txt" #BT
CIL = "countries/Cilicia.txt" #BT
CLN = "countries/Clandeboye.txt" #BT
CMB = "countries/Cambrai.txt" #BT
CMN = "countries/Cremona.txt" #BT
CMO = "countries/Como.txt" #BT
CMR = "countries/Camerino.txt" #BT
CNL = "countries/Carniola.txt" #BT
CNT = "countries/Carinthia.txt" #BT
CPY = "countries/Chipewyan.txt" #BT
CRP = "countries/Carpegna.txt" #BT
CRR = "countries/Correggio.txt" #BT
CST = "countries/Chester.txt" #BT
CTG = "countries/Castiglione.txt" #BT
CTN = "countries/Cortona.txt" #BT
CUI = "countries/Chiusi.txt" #BT
CUM = "countries/Cumania.txt" #BT
CYR = "countries/Cyrenaica.txt" #BT
DBD = "countries/Debdou.txt" #BT
DIE = "countries/Diepholz.txt" #BT
DMA = "countries/Ma.txt" #BT
DNE = "countries/Dene.txt" #BT
DNL = "countries/Danelaw.txt" #BT
DON = "countries/Don.txt" #BT
DOV = "countries/Dovadola.txt" #BT
DPT = "countries/Dapitan.txt" #BT
DRJ = "countries/Dobruja.txt" #BT
DRM = "countries/Darmstadt.txt" #BT
DRP = "countries/Dorpat.txt" #BT
DRT = "countries/Dortmund.txt" #BT
DTK = "countries/Drutsk.txt" #BT
DUR = "countries/Durham.txt" #BT
ECO = "countries/EastConnacht.txt" #BT
EGL = "countries/Egil.txt" #BT 
EGR = "countries/Eger.txt" #BT
EIC = "countries/Eichstatt.txt" #BT
ELL = "countries/Ellwangen.txt" #BT
EMR = "countries/EmiliaRomagna.txt" #BT
ESN = "countries/Essen.txt" #BT
EYK = "countries/Eyak.txt" #BT
FAB = "countries/Fabriano.txt" #BT
FAF = "countries/Farafra.txt" #BT
FCM = "countries/FrancheComte.txt" #BT
FDI = "countries/Fadhli.txt" #BT
FGH = "countries/Fermanagh.txt" #BT
FLD = "countries/Fulda.txt" #BT
FLG = "countries/Foligno.txt" #BT
FMA = "countries/Ma-i.txt" #BT
FMO = "countries/Fermo.txt" #BT
FNG = "countries/Fang.txt" #BT
FNJ = "countries/Btfunj.txt" #BT
FNL = "countries/FinaledelCarretto.txt" #BT
FNZ = "countries/Faenza.txt" #BT
FRE = "countries/Frisia.txt" #BT
FRG = "countries/Freising.txt" #BT
FRL = "countries/Forli.txt" #BT
FST = "countries/Furstenberg.txt" #BT
FTR = "countries/Feltre.txt" #BT
GBG = "countries/Grubenhagen.txt" #BT
GDM = "countries/Nafusi.txt" #BT
GHB = "countries/Gotteshausbund.txt" #BT
GLA = "countries/Glamorgan.txt" #BT
GLC = "countries/RussianGalich.txt" #BT
GLL = "countries/Gallura.txt" #BT
GLU = "countries/Galuh.txt" #BT
GLW = "countries/Galway.txt" #BT
GMV = "countries/GreatMoravia.txt" #BT
GRB = "countries/Grauerbund.txt" #BT
GRN = "countries/Groningen.txt" #BT
GRO = "countries/Grosetto.txt" #BT
GRZ = "countries/Gorizia.txt" #BT
GRU = "countries/Gruyere.txt" #BT
GTA = "countries/Gotaland.txt" #BT
GTT = "countries/Gottingen.txt" #BT
GUB = "countries/Gubbio.txt" #BT
GZR = "countries/Gazaria.txt" #BT
HAK = "countries/Hakkari.txt" #BT 
HEN = "countries/Henneburg.txt" #BT
HDS = "countries/Hidatsa.txt" #BT
HEL = "countries/Heilbronn.txt" #BT
HLB = "countries/Halberstadt.txt" #BT
HLD = "countries/Hildesheim.txt" #BT
HLF = "countries/Helfenstein.txt" #BT
HNA = "countries/Hanau.txt" #BT
HNL = "countries/Hohenlohe.txt" #BT
HOH = "countries/Hohenzollern.txt" #BT
HOP = "countries/Hopi.txt" #BT
HOY = "countries/Hoya.txt" #BT
HWA = "countries/Hawwara.txt" #BT; changed from HAW
IBE = "countries/Iberia.txt" #BT
IDG = "countries/Indragiri.txt" #BT
IDP = "countries/Inderapura.txt" #BT
IFG = "countries/Ifugao.txt" #BT
ILY = "countries/Illyria.txt" #BT
INI = "countries/Ingria.txt" #BT
INK = "countries/Inuktitut.txt" #BT
IST	= "countries/Istria.txt" #BT
ITL = "countries/Italia.txt" #BT
IVE = "countries/Iveagh.txt" #BT
IVR = "countries/Ivrea.txt" #BT
JAE = "countries/Jaen.txt" #BT
JAV = "countries/java-sunda.txt" #BT
JAW = "countries/Jawor.txt" #BT
JEP = "countries/Jepara.txt" #BT
JER = "countries/JerseyandGuernsey.txt" #BT
JMT = "countries/Jamtland.txt" #BT
JUL = "countries/Julich.txt" #BT
JUT = "countries/Jutland.txt" #BT
JYK = "countries/Jayakarta.txt" #BT
KBN = "countries/Kuban.txt" #BT
KCH = "countries/Khachen.txt" #BT
KEM = "countries/Keme.txt" #BT
KET = "countries/Kengtung.txt" #BT
KGC = "countries/Kengcheng.txt" #BT
KIL = "countries/Kilis.txt" #BT
KLU = "countries/Kreuzburg.txt" #BT
KLY = "countries/Kalapuya.txt" #BT
KME = "countries/KhmerEmpire.txt" #BT
KMI = "countries/Kammin.txt" #BT
KMP = "countries/Kempten.txt" #BT
KNT = "countries/KnightsTemplar.txt" #BT
KRO = "countries/Crossen.txt" #BT
KTX = "countries/Kootenay.txt" #BT
KTZ = "countries/Katzenelnbogen.txt" #BT
KUK = "countries/Kuku.txt" #BT
KUM = "countries/Kulm.txt" #BT; changed from KUL
LAO = "countries/Laon.txt" #BT
LCA = "countries/Lancaster.txt" #BT
LCN = "countries/Lucania.txt" #BT
LDA = "countries/Landak.txt" #BT
LEC = "countries/Lecce.txt" #BT
LEG = "countries/Legnica.txt" #BT
LES = "countries/Lesbos.txt" #BT
LGD = "countries/Logudoro.txt" #BT
LGH = "countries/Laghouat.txt" #BT
LGN = "countries/Laigin.txt" #BT; changed from LAI
LGR = "countries/Langres.txt" #BT
LGT = "countries/Latgallia.txt" #BT
LHJ = "countries/Lahej.txt" #BT
LHU = "countries/LowerHungary.txt" #BT
LMV = "countries/LombardyVenetia.txt" #BT
LOD = "countries/London.txt" #BT
LOM = "countries/Lombardy.txt" #BT
LTE = "countries/LatinEmpire.txt" #BT
LXL = "countries/Luxeuil.txt" #BT
MCN = "countries/Macaronesia.txt" #BT
MGH = "countries/Monaghan.txt" #BT
MGK = "countries/Mangkunegaran.txt" #BT
MGT = "countries/Innu.txt" #BT
MHM = "countries/Mahmudi.txt" #BT 
MHN = "countries/Muhlhausen.txt" #BT
MID = "countries/Mercia.txt" #BT
MKG = "countries/Muskegon.txt" #BT
MKR = "countries/Btmakuria.txt" #BT
MLA = "countries/Mologa.txt" #BT; changed from MLG
MMT = "countries/MongMit.txt" #BT
MNC = "countries/Monaco.txt" #BT
MND = "countries/Minden.txt" #BT
MNE = "countries/Maine.txt" #BT
MNF = "countries/Mansfeld.txt" #BT
MNN = "countries/Mnong.txt" #BT
MNO = "countries/Masserano.txt" #BT
MOJ = "countries/Mojave.txt" #BT
MOZ = "countries/Mozhaysk.txt" #BT
MPK = "countries/Malopolska.txt" #BT
MRC = "countries/MarcheofAncona.txt" #BT
MRS = "countries/Moers.txt" #BT
MRT = "countries/Macerata.txt" #BT
MRU = "countries/Mrudah.txt" #BT
MRV = "countries/Moravia.txt" #BT
MSE = "countries/Moosonee.txt" #BT
MSL = "countries/Mosalsk.txt" #BT
MSM = "countries/MassaMarittima.txt" #BT
MSS = "countries/Massa.txt" #BT
#MST = "countries/Munsterberg.txt" #BT, cut
MTA = "countries/Matera.txt" #BT
MTS = "countries/Malatesta.txt" #BT
MTZ = "countries/Metz.txt" #BT
MUR = "countries/Murcia.txt" #BT
MUS = "countries/Muscat.txt" #BT
MVI = "countries/Mondovi.txt" #BT
MWK = "countries/Miwok.txt" #BT
MYO = "countries/Mayo.txt" #BT
NAM = "countries/Namslau.txt" #BT
NBA = "countries/Nubia.txt" #BT
NEG = "countries/Negroponte.txt" #BT
NEO = "countries/Neopatria.txt" #BT
NEU = "countries/Neumark.txt" #BT
NHA = "countries/Nahani.txt" #BT
NIE = "countries/Niesse.txt" #BT
NKR = "countries/Goguryeo.txt" #BT
NRC = "countries/Norcia.txt" #BT
NRD = "countries/Nordlingen.txt" #BT
NTK = "countries/Nootka.txt" #BT; changed from NOO
NUC = "countries/Neuchatel.txt" #BT
NVA = "countries/Novara.txt" #BT
NVT = "countries/Nunavimmiut.txt" #BT
NZP = "countries/NezPerce.txt" #BT
NZZ = "countries/Nizza.txt" #BT
OFF = "countries/Offenburg.txt" #BT
OGL = "countries/Ouargla.txt" #BT
OLE = "countries/Oels.txt" #BT
ORV = "countries/Orvieto.txt" #BT
OSL = "countries/OselWiek.txt" #BT
OTN = "countries/OttomanTunisia.txt" #BT
PAV = "countries/Pavia.txt" #BT
PCZ = "countries/Piacenza.txt" #BT
PEK = "countries/Pekalongan.txt" #BT
PEM = "countries/Pembroke.txt" #BT
PGH = "countries/Priangan.txt" #BT
PHM = "countries/Phimai.txt" #BT
PHP = "countries/PhilippopolisCrusader.txt" #BT
PIE = "countries/Piedmont.txt" #BT
PIO = "countries/Piombino.txt" #BT
PLS = "countries/Palestine.txt" #BT
PMO = "countries/Pomo.txt" #BT
PMS = "countries/Pomesania.txt" #BT
PNN = "countries/Pinneberg.txt" #BT
PNT = "countries/Pontianak.txt" #BT
POI = "countries/Poitou.txt" #BT
PRA = "countries/Prato.txt" #BT
PRI = "countries/Paris.txt" #BT
PRS = "countries/Pronsk.txt" #BT
PRT = "countries/Porto.txt" #BT
PSR = "countries/Pesaro.txt" #BT
PST = "countries/Pistoia.txt" #BT
PUM = "countries/Prum.txt" #BT
QQF = "countries/Jicarilla.txt" #BT
QQG = "countries/Mescalero.txt" #BT
QQH = "countries/Chiracahua.txt" #BT
QQM = "countries/Kainai.txt" #BT
QQN = "countries/Piikani.txt" #BT
QUL = "countries/Qulb.txt" #BT 
RAC = "countries/Ratibor.txt" #BT
RAV = "countries/Ravenna.txt" #BT
REU = "countries/Reuss.txt" #BT
RGO = "countries/Reggio.txt" #BT
RGR = "countries/Regraga.txt" #BT
RHD = "countries/Rhade.txt" #BT
RHI = "countries/Rhineland.txt" #BT
RHM = "countries/Rheims.txt" #BT
RHN = "countries/Rohan.txt" #BT
RIA = "countries/Riau.txt" #BT
RIF = "countries/Riffans.txt" #BT
RIJ = "countries/Rijeka.txt" #BT
RMG = "countries/Romagna.txt" #BT
ROC = "countries/RepublicofCyprus.txt" #BT
ROS = "countries/Rostock.txt" #BT
RTW = "countries/Rottweil.txt" #BT
SAA = "countries/Saarbrucken.txt" #BT
SAG = "countries/Sagan.txt" #BT
SAY = "countries/Sayn.txt" #BT
SBG = "countries/Siebenburgen.txt" #BT
SBW = "countries/Sumbawa.txt" #BT
SCI = "countries/Steinau.txt" #BT
SCH = "countries/Schonburg.txt" #BT
SCN = "countries/Scania.txt" #BT
SCW = "countries/Schwarzburg.txt" #BT
SEM = "countries/Semigallia.txt" #BT
SEV = "countries/Severin.txt" #BT
SGG = "countries/Sanggau.txt" #BT
SGL = "countries/StGallen.txt" #BT
SGP = "countries/Singapore.txt" #BT
SHB = "countries/Schaunburg.txt" #BT
SHE = "countries/Sheki.txt" #BT
SIN = "countries/Sinjar.txt" #BT 
SKD = "countries/Sukadana.txt" #BT
SKR = "countries/Silla.txt" #BT
SLA = "countries/Slavonia.txt" #BT
SLK = "countries/Shilluk.txt" #BT
SLT = "countries/Slutsk.txt" #BT
SLV = "countries/Slavey.txt" #BT
SLW = "countries/Schleswig.txt" #BT
SMA = "countries/Sambia.txt" #BT; changed from SMB
SMG = "countries/Samogitia.txt" #BT
SMS = "countries/Sambas.txt" #BT
SOC = "countries/Socotra.txt" #BT
SPK = "countries/Serpukhov.txt" #BT
SPP = "countries/Soppeng.txt" #BT
SPR = "countries/Selaparang.txt" #BT
SRA = "countries/Sora.txt" #BT
SRB = "countries/Surabaya.txt" #BT
SRK = "countries/Surakarta.txt" #BT
SRN = "countries/Soran.txt" #BT 
SPY = "countries/Speyer.txt" #BT
SSC = "countries/Sipsongchautai.txt" #BT
SSP = "countries/Sipsongpanna.txt" #BT
SSV = "countries/SanSevero.txt" #BT
STG = "countries/Sintang.txt" #BT
STL = "countries/Stolo.txt" #BT
STP = "countries/Stolp.txt" #BT
STR = "countries/Stargard.txt" #BT
STV = "countries/Stavelot.txt" #BT
SVJ = "countries/Srivijaya.txt" #BT
SVL = "countries/Seville.txt" #BT
SVN = "countries/Sovana.txt" #BT
SWD = "countries/Swidnica.txt" #BT
SWK = "countries/Sarawak.txt" #BT
SZE = "countries/Szeklerland.txt" #BT
TAT = "countries/Taranto.txt" #BT; changed from TAN
TAV = "countries/Tavastia.txt" #BT
TCK = "countries/Tecklenburg.txt" #BT
TEG = "countries/Tegali.txt" #BT
TES = "countries/Teschen.txt" #BT
TGI = "countries/Tlingit.txt" #BT
TGL = "countries/Tegal.txt" #BT
TGN = "countries/Toggenburg.txt" #BT
THO = "countries/Thomond.txt" #BT
TIV = "countries/Tivoli.txt" #BT
TKK = "countries/Tekke.txt" #BT
TLD = "countries/Toledo.txt" #BT
TLL = "countries/Tillamook.txt" #BT
TNA = "countries/TirnanGael.txt" #BT
TND = "countries/Tenda.txt" #BT
TNI = "countries/Terni.txt" #BT
TOA = "countries/Tournai.txt" #BT
TOL = "countries/Toul.txt" #BT
TRN = "countries/Saint Pol.txt" #BT
TRO = "countries/Troppau.txt" #BT
TRV = "countries/Treviso.txt" #BT
TSJ = "countries/Transjordan.txt" #BT
TSL = "countries/ThessalonicaCrusader.txt" #BT
TSM = "countries/Tsimshian.txt" #BT
TST = "countries/Trieste.txt" #BT
TTN = "countries/Tortona.txt" #BT
TUG = "countries/Tungur.txt" #BT
UHU = "countries/UpperHungary.txt" #BT
UMB = "countries/Umbria.txt" #BT
UNK = "countries/UnitedKingdomBT.txt" #BT
UNZ = "countries/Unaizah.txt" #BT
UTE = "countries/Ute.txt" #BT
VBZ = "countries/Velbazhd.txt" #BT
VCL = "countries/Vercelli.txt" #BT
VCZ = "countries/Vicenza.txt" #BT
VDN = "countries/Verdun.txt" #BT
VEP = "countries/Vepsians.txt" #BT
VIN = "countries/Vietnam.txt" #BT
VLD = "countries/Vladimir-Suzdal.txt" #BT
VLG = "countries/Vologda.txt" #BT
VLR = "countries/Volterra.txt" #BT
VLT = "countries/Velletri.txt" #BT
VNE = "countries/Vienne.txt" #BT
VOR = "countries/FurtherAustria.txt" #BT
VTN = "countries/Vorotynsk.txt" #BT
VYA = "countries/Vyatka.txt" #BT
WAS = "countries/Washoe.txt" #BT
WCO = "countries/WestConnacht.txt" #BT
WEX = "countries/Wexford.txt" #BT
WJO = "countries/Wajo.txt" #BT
WLD = "countries/Waldeck.txt" #BT
WLF = "countries/Wolfenbuttel.txt" #BT
WMC = "countries/WelshMarches.txt" #BT
WNS = "countries/Ouarsenis.txt" #BT
WOR = "countries/Worms.txt" #BT
WPK = "countries/Wielkopolska.txt" #BT
WRM = "countries/Warmia.txt" #BT
WSX = "countries/Wessex.txt" #BT
WTF = "countries/Waterford.txt" #BT
WTL = "countries/Wethali.txt" #BT
WTZ = "countries/Wetzlar.txt" #BT
WWI = "countries/Mayoo.txt" #BT
WWJ = "countries/Opata.txt" #BT
XXK = "countries/Maliseet.txt" #BT
YGK = "countries/Yogyakarta.txt" #BT
YGW = "countries/Yawnghwe.txt" #BT
YLT = "countries/Yelets.txt" #BT
YPK = "countries/Yupik.txt" #BT
YYA = "countries/Denaina.txt" #BT
YYB = "countries/Aleut.txt" #BT
YYC = "countries/Tanana.txt" #BT
YYD = "countries/Gwichin.txt" #BT
YYE = "countries/Koyukon.txt" #BT
YYF = "countries/Inyupik.txt" #BT
YYG = "countries/Nuxalk.txt" #BT
YYH = "countries/Chimakum.txt" #BT
YYI = "countries/InlandSalish.txt" #BT
YYJ = "countries/Carrier.txt" #BT
YYK = "countries/YnysyKedyrn.txt" #BT
YYL = "countries/Yakama.txt" #BT
YYM = "countries/Umpqua.txt" #BT
YYN = "countries/Paiute.txt" #BT
YYO = "countries/Tongva.txt" #BT
YYP = "countries/Wiyot.txt" #BT
YYQ = "countries/Hupa.txt" #BT
YYR = "countries/Shastan.txt" #BT
YYS = "countries/Salinan.txt" #BT
YYT = "countries/Maidu.txt" #BT
YYU = "countries/Cocopah.txt" #BT
YYV = "countries/Seri.txt" #BT
YYW = "countries/Waikuri.txt" #BT
#YYX = "countries/PlainsCree.txt" #BT
YYY = "countries/WoodsCree.txt" #BT
YYZ = "countries/OjiCree.txt" #BT
YZA = "countries/Tutchone.txt" #BT
YZB = "countries/Lakota.txt" #BT
YZC = "countries/Salteaux.txt" #BT
YZE = "countries/Tuniit.txt" #BT
#YZG = "countries/Laurentian.txt" #BT
YZH = "countries/Missisauga.txt" #BT
YZI = "countries/NeutralConfederacy.txt" #BT
YZW = "countries/HawaiiNation.txt" #BT
YZZ = "countries/Kalaallisut.txt" #BT
ZAB = "countries/Zab.txt" #BT
ZBT = "countries/Zubtsov.txt" #BT
ZEA = "countries/Zealand.txt" #BT
ZGB = "countries/LeagueoftheTenJurisdictions.txt" #BT
ZIA = "countries/Zia.txt" #BT
ZIE = "countries/Ziegenhein.txt" #BT
ZIR = "countries/Zirqan.txt" #BT 
ZDN = "countries/Zenden.txt" #BT
ZOS = "countries/Zossen.txt" #BT
ZUR = "countries/Zurich.txt" #BT