#Tags from Shattered Europa:

#Scandinavia
AAL = "countries/Aaland.txt"
JMT = "countries/Jamtland.txt"
JUT = "countries/Jutland.txt"
SCN = "countries/Scania.txt"
TAV = "countries/Tavastia.txt"
ZEA = "countries/Zealand.txt"

#France
PRI = "countries/Paris.txt"
POI = "countries/Poitou.txt"

#Iberia
AJO = "countries/Alentejo.txt"
PRT = "countries/Porto.txt"
MCN = "countries/Macaronesia.txt"

#British Isles
MID = "countries/Mercia.txt"
LOD = "countries/London.txt"
WSX = "countries/Wessex.txt"
DNL = "countries/Danelaw.txt"

#Russia
VLD = "countries/Vladimir-Suzdal.txt"
VEP = "countries/Vepsians.txt"
INI = "countries/Ingria.txt"

#Poland
NEU = "countries/Neumark.txt"
MPK = "countries/Malopolska.txt"
WPK = "countries/Wielkopolska.txt"

#Baltic
LGT = "countries/Latgallia.txt"
SEM = "countries/Semigallia.txt"

#Far East
BKJ = "countries/Baekje.txt"
NKR = "countries/Goguryeo.txt"
SKR = "countries/Silla.txt"

#Egypt
ALX = "countries/Alexandria.txt"
CYR = "countries/Cyrenaica.txt"
FAF = "countries/Farafra.txt"

#Pontic Steppe
DON = "countries/Don.txt"
KBN = "countries/Kuban.txt"

#Tags from Byzantine Resurgence (Some from Shattered Europa originally)

#Balkans
NEO = "countries/Neopatria.txt"
NEG = "countries/Negroponte.txt"
PHP = "countries/PhilippopolisCrusader.txt"
TSL = "countries/ThessalonicaCrusader.txt"

#Levant
ATC = "countries/Antioch.txt"