# Balkans
AET = "countries/Aetolia.txt"
BGS = "countries/Burgas.txt"
BZY = "countries/Bizya.txt"
CLD = "countries/Chalkdiki.txt"
CRH = "countries/Corinth.txt"
DDL = "countries/Dardanelles.txt"
KST = "countries/Kastoria.txt"
MDN = "countries/Macedonia.txt"
OPT = "countries/Optimatoi.txt"
PAI = "countries/Paristrion.txt"
PCS = "countries/Phocis.txt"
RSC = "countries/Rascia.txt"
SBR = "countries/Selymbria.txt"
SYA = "countries/Syrmia.txt"
TRC = "countries/Thrace.txt"
TSY = "countries/Thessaly.txt"
VLS = "countries/Volos.txt"
YAB = "countries/Yambol.txt"
ZAD = "countries/Zadar.txt"

# Albion
CBI = "countries/Cumbria.txt"
DFD = "countries/Dyfed.txt"
EAG = "countries/EastAnglia.txt"
ESX = "countries/Essex.txt"
GWD = "countries/Gwynedd.txt"
GWE = "countries/Gwent.txt"
GWY = "countries/Galloway.txt"
JRV = "countries/Jorvik.txt"
KEN = "countries/Kent.txt"
MGS = "countries/Maggenset.txt"
PCK = "countries/Peckset.txt"
PWS = "countries/Powys.txt"
SSX = "countries/Sussex.txt"
STC = "countries/Strathclyde.txt"
WKS = "countries/Wreakset.txt"
WTC = "countries/Whitch.txt"

# Ireland
CRK = "countries/Cork.txt"
DGA = "countries/Donegal.txt"
DUB = "countries/Dublin.txt"
RCM = "countries/Roscommon.txt"

# France
AGL = "countries/Angouleme.txt"
AGN = "countries/Agenais.txt"
BRN = "countries/Bearne.txt"
CCS = "countries/Carcassonne.txt"
CHN = "countries/ChannelIslands.txt"
DBG = "countries/Bourgogne.txt"
ESC = "countries/Escartons.txt"
FEU = "countries/Eu.txt"
FRB = "countries/Fribourg.txt"
FTS = "countries/Tours.txt"
GUI = "countries/Guise.txt"
HBN = "countries/Bern.txt"
HPX = "countries/Hurepoix.txt"
LDC = "countries/Languedoc.txt"
LMC = "countries/LaMarche.txt"
LNS = "countries/Lyonnais.txt"
NBN = "countries/Narbonne.txt"
OCC = "countries/Occitania.txt"		# Formable
RTH = "countries/Rethel.txt"
SOI = "countries/Soissons.txt"
VSL = "countries/Vesoul.txt"
WLL = "countries/Wallis.txt"

# Iberia
BGC = "countries/Braganca.txt"
EON = "countries/Eonavia.txt"
STD = "countries/Santander.txt"
TOM = "countries/TrasOsMontes.txt"

# HRE
JRB = "countries/Jutribok.txt"
LSL = "countries/LowerSilesia.txt"
LUT = "countries/Luticia.txt"
MSO = "countries/Misno.txt"
NGU = "countries/Nordgau.txt"
OST = "countries/Ostfalen.txt"
STO = "countries/Santok.txt"
USL = "countries/UpperSilesia.txt"

# North Italy
ACQ = "countries/Acqui.txt"
AOS = "countries/Aosta.txt"
CNI = "countries/Carnia.txt"

# South Italy
CTA = "countries/Capitanata.txt"
GET = "countries/Gaeta.txt"
MLS = "countries/Molise.txt"
TCA = "countries/Trinacria.txt"

# Scandinavia
ABO = "countries/Abo.txt"
KNU = "countries/Kainuu.txt"
OSB = "countries/Ostrobothnia.txt"
SAN = "countries/Savonia.txt"
SKN = "countries/Satakunta.txt"
SVB = "countries/Svalbard.txt"
USM = "countries/Uusimaa.txt"

# Poland and Baltics
AUK = "countries/Aukstaitija.txt"
BGR = "countries/Bialogard.txt"
LEK = "countries/Lek.txt"
MSU = "countries/Masuria.txt"
PME = "countries/Pomerelia.txt"
SGR = "countries/Starogard.txt"
TCH = "countries/Techolo.txt"
TSO = "countries/Truso.txt"

# Hungary
BNT = "countries/Banat.txt"

# East Europe
BOL = "countries/Bolghar.txt"
BJA = "countries/Bjarmia.txt"
BKV = "countries/Bukovina.txt"
CVS = "countries/Chuvash.txt"
GTH = "countries/Gothia.txt"
HRO = "countries/Hrodna.txt"
ITI = "countries/Itil.txt"
LVD = "countries/Levedia.txt"
MDV = "countries/Mordvinia.txt"
MRM = "countries/Murom.txt"
MSK = "countries/Minsk.txt"
PEC = "countries/Pechenegia.txt"
PNS = "countries/Pinsk.txt"
PSL = "countries/Pereyaslavl.txt"
SVR = "countries/Seversk.txt"
QGR = "countries/Qangaria.txt"
VNH = "countries/Voronezh.txt"

# Asia Minor
GLT = "countries/Galatia.txt"
KRS = "countries/Korakesion.txt"
LYC = "countries/Lycia.txt"
NIK = "countries/Nikaea.txt"
PGI = "countries/Pegai.txt"
PHI = "countries/Philadelphia.txt"
PON = "countries/Pontus.txt"
VAR = "countries/VarangianLeague.txt"

# Caucasus
ALN = "countries/Alania.txt"
KMK = "countries/Kumykia.txt"
LKA = "countries/Lekia.txt"
SSR = "countries/Simsir.txt"
TMT = "countries/Tmutarakan.txt"
ZIC = "countries/Zichia.txt"

# North Africa
ANM = "countries/Ainam.txt"
AIT = "countries/Auarita.txt"
BIZ = "countries/Bizerte.txt"
DAK = "countries/Dakhla.txt"
GHT = "countries/Ghat.txt"
KAI = "countries/Kairouan.txt"
KEF = "countries/Kef.txt"
KRG = "countries/Kharga.txt"
MHD = "countries/Mahdia.txt"
ORN = "countries/Oran.txt"
TBA = "countries/Tabarka.txt"
TGR = "countries/Tangiers.txt"
TLS = "countries/Talsint.txt"
WZZ = "countries/Warzazat.txt"

# East Africa
OAJ = "countries/OuterAjuraan.txt"
RHF = "countries/RasHafun.txt"
WAJ = "countries/WestAjuraan.txt"

# Middle East
ABS = "countries/Abbasids.txt"
DAY = "countries/Daylam.txt"
FJD = "countries/Falajid.txt"
GAE = "countries/Galilee.txt"
HSH = "countries/Hashimid.txt"
NHL = "countries/Nekhel.txt"
SIN = "countries/Sinai.txt"
SJK = "countries/Seljuk.txt"
TUK = "countries/Tabuk.txt"
TYE = "countries/Tyre.txt"
UTJ = "countries/Ultrajordania.txt"

# Iran
BKH = "countries/Balkh.txt"
KLA = "countries/Kalat.txt"
MRN = "countries/Makran.txt"

# Central Asia
KHT = "countries/Khitan.txt"
KLS = "countries/Karlukistan.txt"
KPC = "countries/Kypchak.txt"
OGZ = "countries/Oghuz.txt"
QOC = "countries/Qocho.txt"
SGD = "countries/Sughd.txt"
ZHT = "countries/Zhetysu.txt"

# South-East Asia
HPC = "countries/Hariphunchai.txt"
LAV = "countries/Lavo.txt"
PAG = "countries/Pagan.txt"
XTG = "countries/XiengThong.txt"

# Far East
AMD = "countries/Amdo.txt"
DNH = "countries/DongNuzhen.txt"
GKR = "countries/Goryeo.txt"
NAI = "countries/Naiman.txt"
NRG = "countries/Nurgan.txt"
ORO = "countries/Orochen.txt"
SNG = "countries/Song.txt"
URK = "countries/Uriankhai.txt"